数组的类型相关
方法	                            描述	                                          备注
Array.isArray()	                    判断是否为数组	
toString()	                        将数组转换为字符串	                               不会改变原数组
join()	                            将数组转换为字符串，返回结果为转换后的字符串        不会改变原数组
字符串的方法：split()	            将字符串按照指定的分隔符，组装为数组	            不会改变原字符串
Array.from(arrayLike)	            将伪数组转化为真数组	
Array.of(value1, value2, value3)	创建数组：将一系列值转换成数组	

数组元素的添加和删除
push()                  向数组的最后面插入一个或多个元素，返回结果为新数组的长度     会改变原数组
pop()                   删除数组中的最后一个元素，返回结果为被删除的元素            会改变原数组
unshift()	在数组最前面插入一个或多个元素，返回结果为新数组的长度                      会改变原数组
shift()	删除数组中的第一个元素，返回结果为被删除的元素	会改变原数组
splice()	从数组中删除指定的一个或多个元素，返回结果为被删除元素组成的新数组          会改变原数组
slice()	从数组中提取指定的一个或多个元素，返回结果为新的数组                            不会改变原数组
concat()	合并数组：连接两个或多个数组，返回结果为新的数组                            不会改变原数组
fill()	填充数组：用固定的值填充数组，返回结果为新的数组                                会改变原数组

数组排序 
reverse()	反转数组，返回结果为反转后的数组	会改变原数组
sort()	对数组的元素,默认按照Unicode 编码，从小到大进行排序	会改变原数组

遍历数组 
for 循环	最传统的方式遍历数组，这个大家都懂	
forEach()	遍历数组，但需要兼容 IE8 以上	不会改变原数组。forEach() 没有返回值。也就是说，它的返回值是 undefined
for of	遍历数组（ES6语法）	不会改变原数组。另外，不要使用 for in 遍历数组
map()	对原数组中的每一项进行加工，将组成新的数组	不会改变原数组
filter()	过滤数组：返回结果是 true 的项，将组成新的数组，返回结果为新的数组	不会改变原数组
reduce	接收一个函数作为累加器，返回值是回调函数累计处理的结果	比较复杂